europe = { 
	1 
}
asia = { 
}
africa = { 
}
north_america = { 
}
south_america = { 
}
oceania = { 
}
# Used for RNW
new_world = { 
}
eweia = { 
	2055 2031 2037 2065 2075 2058 2026 2025 2022 2014
	2012 2013 2018 2015 2019 2033 2034 2040 2039 2057
	2069 2070 2056 2083 2076 2086 2080 2059 2045 2044
	2052 2030 2024 2010 2003 1987 1991 1975 1980 1955
	1973 1961 1952 1945 1958 1940 1927 1913 1923 1895
	1910 1905 1899 1906 1919 1933 1925 1946 1944 1956
	1963 1974 1951 1957 1972 1985 2000 1995 1988 2011
	2023 2008 2027 2016 2004 1994 2005 2002 1996 2007
	2029 2032 2021 2043 2051 2064 2081 2085 2078 2094
	2082 2099 2107 2117 2130 2127 2121 2100 2113 2105
	2122 2115 2104 2111 2093 2084 2067 2066 2063 2062
	2060 2047 2073 2042 2036 2035 2028 2038 2041 2050
	2061 2054 2046 2053 2071 2079 2068 2072 2090 2088
	2096 2087 2089 2098 2112 2097 2109 2114 2123 2124
	2119 2126 2131 2128 2125 2110 2116 2092 2095 2101
	2091 
}
